111111111111111111111111111111
111111111111111000000000011111
100000000000000000000000011111
100000000000000000000000011111
100000000000000000000000011111
100000000000000000000000011111
100000000000000000000000011111
100000000000000000000000011111
1000000000000E0P00000000011111
100000000000000000000000011111
100000000000C00000000000011111
100000000000000000000000011111
100000000000000000000000011111
100000000000000000000000011111
111111111111111111111111111111
111111111111111111111111111111