1111111
1P0CCC1
1C11111
1C00001
11010C1
1C10EC1
1111111
