1111111
10E0001
1ECP111
1111111