11111111
1C0000P1
1ECC01C1
111001C1
100001C1
11111111