11111111111
1C0000000P1
1ECC00001C1
111000001C1
100000001C1
11111111111