11111111111
1C1100000P1
1ECC10001C1
111000001C1
1C0000001C1
10000000001
11000000001
11100000001
10000000001
10000000CC1
1CCCCC11111
11111111111