11111111111
1C1100000P1
1ECC10001C1
111000001C1
1C0000001C1
11111111111