111111111111
1P0000000001
111111111011
1C0000000001
111011111111
1C0000000001
1111111110E1
111111111111