1111111
1P00001
1111011
1C000E1
1111111