1111111
1P00001
1111111
1C00001
1110E11
1111111