1111111
1C000P1
1C11111

1110E11
1111111