111111111111
1P0000000001
110000001011
1C0000000001
111000000011
1C0000000001
1111111110E1
111111111111