111111111111111111111111
1P0000000000000000000001
110000001011111000001011
1C0000000000000000000001
111000000011111000000011
1C0000000000000000000001
111111111000000000E00001
111111111000000000111111
1C000CCCCCCCCCCCCCCCC001
110000001011111000001011
1C0000000000000000000001
111111111111111111111111
