11111111111
1CCCCCCCCP1
10000000001
11111110001
10000000001
10000000001
10000000001
1C000000001
1C000000001
1C000000001
1C000000001
1C000000001
1C000000001
1C000000001
1C000000001
1C000000001
1C000000001
111111E1111
11111111111