1111111
1000000
100CPE0
1111111