11111111
10000001
10000000
11111111