1111111
1P00C01
1000011
1C00101
1010E01
1111111